0000000000000000000000000000000000000000000000000000000000000000000000
0000000000000000000000000000000000000000000000000000000000000000000000
0000000000000000000000000000000000000000000000000000000000000000000000
0000000000000000000000000000000000000000000000000000000000000000000000
0000000000000000000000000000000000000000000000000000000000000000000000
0000000000000000000000000000000000000000000000000000000000000000000000
0000000000000000000000000000000000000000000000000000000000000000000000
0000000000000000000000000000000000000000000000000000000000000000000000
0000000000000000000000000000000000000000000000000000000000000000000000
8333333333333333333333333333333333333333333333333333333370000008333333
4222222222222222222222222222222222222222222222222222222250000004222222
4111111111111111111111111111111111111111111111111111111150000004111111
4111111111111111111111111111111111111111111111111111111150000004111111
4111111111111111111111111111111111111111111111111111111153333334111111
4111111111111111111111111111111111111111111111111111111122222222111111
4111111111111111111111111111111111111111111111111111111111111111111111
4111111111111111111111111111111111111111111111111111111111111111111111
4111111111111111111111111111111111111111111111111111111111111111111111
4111111111111111111111111111111111111111111111111111111111111111111111
4111111111111111111111111111111111111111111111111111111111111111111111
4111111111111111111111111111111111111111111111111111111111111111111111
4111111111111111111111111111111111111111111111111111111111111111111111
4111111111111111111111111111111111111111111111111111111111111111111111
4111111111111111111111111111111111111111111111111111111111111111111111
4111111111111111111111111111111111111111111111111111111111111111111111
4111111111111111111111111111111111111111111111111111111111111111111111
4111111111111111111111111111111111111111111111111111111111111111111111
4111111111111111111111111111111111111111111111111111111111111111111111
4111111111111111111111111111111111111111111111111111111111111111111111
4111111111111111111111111111111111111111111111111111111111111111111111
4111111111111111111111111111111111111111111111111111111111111111111111
4111111111111111111111111111111111111111111111111111111111111111111111
4111111111111111111111111111111111111111111111111111111111111111111111
4111111111111111111111111111111111111111111111111111111111111111111111
4111111111111111111111111111111111111111111111111111111111111111111111
4111111111111111111111111111111111111111111111111111111111111111111111
4111111111111111111111111111111111111111111111111111111111111111111111
4111111111111111111111111111111111111111111111111111111111111111111111
4111111111111111111111111111111111111111111111111111111111111111111111
4111111111111111111111111111111111111111111111111111111111111111111111
4111111111111111111111111111111111111111111111111111111111111111111111
4111111111111111111111111111111111111111111111111111111111111111111111
4111111111111111111111111111111111111111111111111111111111111111111111
4666666666666666666666666666666666666666666666666666666666666666666666