00000000000000000000
00000000000000000000
00000000000000000000
00000000000000000000
00000000000000000000
00000000000000000000
00000000000000000000
00000000000000000000
00000000000000000000
83333333333333333333
42222222222222222222
41111111111111111111
41111111111111111111
41111111111111111111
41111111111111111111
41111111111111111111
41111111111111111111
41111111111111111111
41111111111111111111
41111111111111111111
41111111111111111111
41111111111111111111
41111111111111111111
41111111111111111111
41111111111111111111
41111111111111111111
41111111111111111111
41111111111111111111
41111111111111111111
41111111111111111111
41111111111111111111
41111111111111111111
41111111111111111111
41111111111111111111
41111111111111111111
41111111111111111111
41111111111111111111
41111111111111111111
41111111111111111111
41111111111111111111
41111111111111111111
41111111111111111111
41111111111111111111
46666666666666666666