00000000000000000000
00000000000000000000
00000000000000000000
00000000000000000000
00000000000000000000
00000000000000000000
00000000000000000000
00000000000000000000
00000000000000000000
00000000000000000000
00000000000000000000
00000000000000000000
00000000000000000000
00000000000000000000
00000000000000000000
00000000000000000000
00000000000000000000
00083370000000000833
00042250000000000422
00041150000000000411
33341150000000000411
22221150000000000411
66611150000000000411
00041150000000000411
00041150000000000411
00041150000000000411
00041150000000000411
33341150000000000411
22221150000000000411
11111150000000000411
11111150000000000411
11111150000000000411
11111150000000000411
11111150000000000411
11111150000000000411
11111150000000000411
11111150000000000411
11111150000000000411
11111150000000000411
11111150000000000411
11111150000000000411
11111150000000000411
11111150000000000411
66666650000000000466