00000000000000000000
00000000000000000000
00000000000000000000
00000000000000000000
00000000000000000000
00000000000000000000
00000000000000000000
00000000000000000000
00000000000000000000
33333333337000000000
22222222225000000000
11111111115000000000
11111111115000000000
11111111115000000000
11111111115000000000
11111111115000000000
11111111115000000000
11111111115000000000
11111111115000000000
11111111115000000000
11111111115000000008
11111111115000000004
11111111115000000004
11111111115000000004
11111111115000000004
11111111115000000004
11111111115000000004
11111111115000000004
11111111115000000004
11111111115000000004
11111111115000000004
11111111115333333334
11111111112222222222
11111111115666666666
11111111115000000000
11111111115000000000
11111111115000000000
11111111115000000000
11111111115000000000
11111111115000000000
11111111115000000000
11111111115000000000
11111111115000000000
66666666665000000000