00000000000000000000
00000000000000000000
00000000000000000000
00000000000000000000
00000000000000000000
00000000000000000000
00000000000000000000
00000000000000000000
00000000000000000000
00000000000000000000
00000000000000000000
00000000000000000000
00000000000000000000
00000000000000000000
00000000000000000000
00000000000000000000
00000000000000000000
00000000000000000000
00000000000000000000
00000000000000000000
33333333333333333333
22222222222222222222
16666666666666666666
15000000000000000000
15000000000000000000
15000000000000000000
15000000000000000000
15000000000008333333
15000000000004222222
15000000000004666666
15000000000000000000
15000000000000000000
15337000000000000000
12225000000000000000
66665000000000000083
00000000000000000042
00000000000000000046
00000000000000000000
00000000000000000000
00000000000000000000
00000000000837000000
00000000000425000000
00000000000465000000
00000000000000000000