00000000000000000000
00000000000000000000
00000000000000000000
00000000000000000000
00000000000000000000
83333333333333333700
42222222222222222500
46666664111111111500
00000004111111111500
00000004111111111500
00000004111111111500
00000004111111111500
00000004111111111500
00000004111111111500
00000004111111111500
00000004111111111500
00000004111111111500
00000004111111111500
00837004111111111500
00425004111111111500
33415004111111111500
22215004111111111500
66665004111111111500
00000004111111111500
00000004111111111500
00000004111111111500
00000004111111111500
33333334111111111533
22222222111111111222
11111111111111111111
66666666666666666666
00000000000000000000
00000000000000000000
00000000000000000000
33333333333333333333
22222222222222222222
66666661111111111111
00000004111111111111
00000004111111111111
00000004111111111111
00000004111111111111
00000004111111111111
00000004111111111111
00000004666666666666