00000000000000000000
00000000000000000000
00000000000000000000
00000000000000000000
00000000000000000000
00000000000000000000
00000000000000000000
00000000000000000000
00000000000000000000
00000000000000000000
00000000000000000000
00000000000000000000
00000000000000000000
00000000000000000008
00000000000000000004
00000000000000000004
00000000000000000000
00000000000000000000
00000008370000000000
00000004250000000000
00000004650000000000
00000000000000000000
00000000000000000000
00000000000000000000
00000000000000008370
00000000000000004250
00000000000000004650
33337000000000000000
22225000000000000000
11115000000000000000
66665000000000000000
00000000000000000000
00000000000000000000
00000000000000000000
33333337000000000000
22222225000000000000
11111115000000000000
11111115000000000000
11111115333333333333
11111112222222222222
11111111111111111111
11111111111111111111
11111111111111111111
66666666666666666666