00000000000000000000
00000000000000000000
00000000000000000000
00000000000000000000
00000000000000000000
00000000000000000000
00000000000000000000
00000000000008370000
00000000000004250000
00000000000004650000
00000000000000000000
00000000000000000000
37000000000000000000
25000000000000000000
65000000000000000000
00000000000000000000
00000000000000000000
00000000000000000000
00000000000000000000
00000000000000000000
00000000000000000000
00000000000000000000
00000000000000000000
00000000000000000000
00000000000000000000
00000000000000000000
00000000000000000000
00000000000000000000
00000000000000000000
00000000000000000000
00000000000000000000
00000008370000000000
00000004250000000000
00000004650000000000
00000000000083333333
00000000000042222222
00000000000041111111
00000000000041111111
33333333333341111111
22222222222221111111
11111111111111111111
11111111111111111111
11111111111111111111
66666666666666666666