00000000000000000000
00000000000000000000
00000000000000000000
00000000000000000000
00000008333333333333
00000004222222222222
00000004111111111111
00000834111111111111
00000422111111111111
00000466111111111111
00000004111111111111
00000004111111111111
00000004111111111111
00000004111111111111
00000004111111111111
00000004111111111111
00000004111111111111
00000004111111111111
00000004111111111111
00000004111111111111
00000004111111111111
00000004111111111111
00000004111111111111
00000004111111111111
00000004111111111111
00000004111111111111
00000004111111111111
00000004111111111111
00000004111111111111
00000004111111111111
00000004111111111111
00000004111111111111
00000004111111111111
00000004111111111111
33333334111111111111
22222222111111111111
11111111111111111111
11111111111111111111
11111111111111111111
11111111111111111111
11111111111111111111
11111111111111111111
11111111111111111111
66666666666666666666