0000000000000000000000000833370000000000000000000000000000000000000000
0000000000000000000000000422250000000000000000000000000000000000000000
0000000000000000000000000411150000000000000000000000000000000000000000
0083333333370000000000000466650000000833337000000000000000000000000000
0042222222250000000000000000000000000422225000000000000000000000000000
0041111111150000000000000000000000000411115000000000000000000000000000
0046666666650000000000000000000000000411115000000000000000000000000000
0000000000000000000000000000000000000411115000000000000000000000000000
0000000000000000000000000000000000000411115000000000000000000000000000
3333333333337000000000000000000000000411115000000000833333333380000000
2222222222225000000000000000000000000411115000000000422222222250000000
1111111111115000000000000000000000000411115000000000411111111150000000
1111111111115333333333333333333333333411115000000000411111111153333370
1111111111112222222222222222222222222211115000000000411111111122222250
1111111111111111111111111111111111111111115000000000411111111111111150
1111111111111111111111111111111111111111115000000000466666666666666650
1111111111111111111111111111111111111111115000000000000000000000000000
1111111111111111111111111111111111111111115000000000000000000000000000
1111111111111111111111111111111111111111115000000000000000000000000000
1111111111111111111111111111111111111111115000000000000000000000000000
1111111111111111111111111111111111111111115000000000000000000000000000
1111111111111111111111111111111111111111115000000000000000000000000000
1111111111111111111111111111111111111111115000000083333333333333333333
1111111111111111111111111111111111111111115000000042222222222222222222
1111111111111111111111111111111111111111115000000041111111111111111111
1111111111111111111111111111111111111111115000000041111111111111111111
1111111111111111111111111111111111111111115000000041111111111111111111
1111111111111111111111111111111111111111115000000041111111111111111111
1111111111111111111111111111111111111111115000000041111111111111111111
1111111111111111111111111111111111111111115000000041111111111111111111
1111111111111111111111111111111111111111115000000041111111111111111111
1111111111111111111111111111111111111111115000000041111111111111111111
1111111111111111111111111111111111111111115000000041111111111111111111
1111111111111111111111111111111111111111115000000041111111111111111111
1111111111111111111111111111111111111111115000000041111111111111111111
1111111111111111111111111111111111111111115000000041111111111111111111
1111111111111111111111111111111111111111115000000041111111111111111111
1111111111111111111111111111111111111111115000000041111111111111111111
1111111111111111111111111111111111111111115000000041111111111111111111
1111111111111111111111111111111111111111115000000041111111111111111111
1111111111111111111111111111111111111111115000000041111111111111111111
1111111111111111111111111111111111111111115000000041111111111111111111
1111111111111111111111111111111111111111115000000041111111111111111111
6666666666666666666666666666666666666666665000000046666666666666666666