0000000000000000000000000000000000000000000000000000000000000000000000
0000000000000000000000000000000000000000000000000000000000000000000000
0000000000000000000000000000000000000000000000000000000000000000000000
0000000000000000000000000000000000000000000000000000000000000000000000
0000000000000000000000000000000000000000000000000000000000000000000000
0000000000000000000000000000000000000000000000000000000000000000000000
0000000000000000000000000000000000000000000000000000000000000000000000
0000000000000000000000000000000000000000000000000000000000000000000000
0000000000000000000000000000000000000000000000000000000000000000000000
0000000000000000000000000000000000000000000000000000000000000000833700
0000000000000000000000000000000000000000000000000000000000000000422500
0000000000000000000000000000000000000000000000000000000000000000411500
0000000000000000000000000000000000000000000000000000000000000000466500
0000000000000000000000000000000000000000000000000000000000000000000000
0000000000000000000000000000000000000000000000000000000000000000000000
0000000000000000000000000000000000000000000000000000000000000000000000
0000000000008380000000000000000000000000000000000000000000000000000000
0000000000004250000000000000000000000000000833700000000008333333333333
0000000000004650000000000000000000000000000422500000000004222222222222
0000000000000000000000000000000000000000000411500000000004111111111111
0000000000000000008333333333333333333333333411500000000004111111111111
0000000000000000004222222222222222222222222211500000000004111111111111
3700000000000000004666666666666666666666666111500000000004111111111111
2500000000000000000000000000000000000000000411500000000004111111111111
1500000000000000000000000000000000000000000411500000000004111111111111
1500000000000000000000000000000000000000000411500000000004111111111111
1500000000000000000000000000000000000000000411500000000004111111111111
1500000000000000083333333333333333333333333411500000000004111111111111
1500000000000000042222222222222222222222222211500000000004111111111111
1500000000000000041111111111111111111111111111500000000004111111111111
1500000000000000041111111111111111111111111111500000000004111111111111
1500000000000000041111111111111111111111111111500000000004111111111111
1500000000000000041111111111111111111111111111500000000004111111111111
1533333333333333341111111111111111111111111111500000000004111111111111
1222222222222222221111111111111111111111111111500000000004111111111111
1111111111111111111111111111111111111111111111500000000004111111111111
1111111111111111111111111111111111111111111111500000000004111111111111
1111111111111111111111111111111111111111111111500000000004111111111111
1111111111111111111111111111111111111111111111500000000004111111111111
1111111111111111111111111111111111111111111111500000000004111111111111
1111111111111111111111111111111111111111111111500000000004111111111111
1111111111111111111111111111111111111111111111500000000004111111111111
1111111111111111111111111111111111111111111111500000000004111111111111
6666666666666666666666666666666666666666666666500000000004666666666666