000000000000000000000000000000000000000000000000000000000000000000000000000000000000000000000000000000000000000000000000000000000000000000000000000000000000000000000000000000000000000000000000000000000000000000
0000000000000000000000000422250000000000000000000000000000000000000000000000000000000000000000000000000000000000000000000000000000000000000000000000000000000000000000000000000000000000000000000000000000000000000000000000000000000000000000000000000000000000000000000000000000000000
0000000000000000000000000411150000000000000000000000000000000000000000000000000000000000000000000000000000000000000000000000000000000000000000000000000000000000000000000000000000000000000000000000000000000000000000000000000000000000000000000000000000000000000000000000000000000000
0083333333370000000000000466650000000833337000000000000000000000000000000000000000000000000000000000000000000000000000000000000000000000000000000000000000000000000000000000000000000000000000000000000000000000000000000000000000000000000000000000000000000000000000000000000000000000
0042222222250000000000000000000000000422225000000000000000000000000000000000000000000000000000000000000000000000000000000000000000000000000000000000000000000000000000000000000000000000000000000000000000000000000000000000000000000000000000000000000000000000083333333333333333333337
0041111111150000000000000000000000000411115000000000000000000000000000000000000000000000000000000000000000000000000000000000000000000000000000000000000000000000000000000000000000000000000000833333333333333337000000000000000000000000000000000000000000000000042222222222222222222225
0046666666650000000000000000000000000411115000000000000000000000000000000000000000000000000000000000000000000000000000000000000000000000000000000000000000000000000000000000000000000000000000422222222222222225000000000000000000000000000000000000000000000000041111111111111111111115
0000000000000000000000000000000000000411115000000000000000000000000000000000000000000000000000000000000000000000000000000000000000000000000000000000000000000000000000000000000000000000000000466666641111111115000000000000000000000000000000000008370000000000041111111111111111111115
0000000000000000000000000000000000000411115000000000000000000000000000000000000000000000000000000000000000000000000000000000000000000000000000000000000000000000000000000000000000000000000000000000041111111115000000000000000000000000000000000004250000000000041111111111111111111115
3333333333337000000000000000000000000411115000000000833333333380000000000000000000000000000000000000000000000000000000000000000000000083370000000000833333333333700000000000000000000000000000000000041111111115000000000000000000000000000000000004650000000000041111111111111111111115
2222222222225000000000000000000000000411115000000000422222222250000000000000000000000000000000000000000000000000000000000000000000000042250000000000422222222222500000000000000000000000000000000000041111111115000000000000000000000000000000000000000000000000041111111111111111111115
1111111111115000000000000000000000000411115000000000411111111150000000000000000000000000000000000000000000000000000000000000000000000041150000000000411111111111500000000000000000000000000000000000041111111115000000000000000000000000000000000000000000000000041111111111111111111115
1111111111115333333333333333333333333411115000000000411111111153333370000000000000000000000000000000000000000000000000000000000000000046650000000000411111111111500000000000000000000000000000000000041111111115000000000000000000000837000000000000000000000000041111111111111111111115
1111111111112222222222222222222222222211115000000000411111111122222250000000000000000000000000000000000000000000000000000000000000000000000000000000411111111111500000000000000000000000000000000000041111111115000000000000000000000425000000000000000000000000041111111111111111111115
1111111111111111111111111111111111111111115000000000411111111111111150000000000000000000000000000000000000000000000000000000000000000000000000833333411111111111500000000000000000000000000000000000041111111115000000000000000000000465000000000000000000000000041111111111111111111115
1111111111111111111111111111111111111111115000000000466666666666666650000000000000000000000000000000000000000000000000000000000000000000000000422222211111111111500000000000000000000000000000000000041111111115000000000000000000000000000000000000000000000000041111111111111111111115
1111111111111111111111111111111111111111115000000000000000000000000000000000000000838000000000000000000000000000000000000000000000000000000000411111111111111111500000000000000000000000000000000000041111111115000000000000000000000000000000000000000000000000041111111111111111111115
1111111111111111111111111111111111111111115000000000000000000000000000000000000000425000000000000000000000000000083370000000000833333333333333411111111111111111500000000000000000000000000000000000041111111115000000000000000000000000000000000000000000000000041111111111111111111115
1111111111111111111111111111111111111111115000000000000000000000000000000000000000465000000000000000000000000000042250000000000422222222222222211111111111111111500000000000000000000000000000008370041111111115000000000837000000000000000000000000000000000000041111111111111111111115
1111111111111111111111111111111111111111115000000000000000000000000000000000000000000000000000000000000000000000041150000000000411111111111111111111111111111111500000000000000000000000000000004250041111111115000000000425000000000000000000000000000000000000041111111111111111111115
1111111111111111111111111111111111111111115000000000000000000000000000000000000000000000833333333333333333333333341150000000000411111111111111111111111111111111500000000833333333333333333333334150041111111115000000000465000000000000000000000000000000000000041111111111111111111115
1111111111111111111111111111111111111111115000000000000000000000000000000000000000000000422222222222222222222222221150000000000411111111111111111111111111111111500000000422222222222222222222222150041111111115000000000000000000000000000000000000000000000000041111111111111111111115
1111111111111111111111111111111111111111115000000083333333333333333333370000000000000000466666666666666666666666611150000000000411111111111111111111111111111111500000000416666666666666666666666650041111111115000000000000000000000000000000000000000000000000041111111111111111111115
1111111111111111111111111111111111111111115000000042222222222222222222250000000000000000000000000000000000000000041150000000000411111111111111111111111111111111500000000415000000000000000000000000041111111115000000000000000000000000000000000000000000000000041111111111111111111115
1111111111111111111111111111111111111111115000000041111111111111111111150000000000000000000000000000000000000000041150000000000411111111111111111111111111111111500000000415000000000000000000000000041111111115000000000000000000837000000000000000000000000000041111111111111111111115
1111111111111111111111111111111111111111115000000041111111111111111111150000000000000000000000000000000000000000041150000000000411111111111111111111111111111111500000000415000000000000000000000000041111111115000000000000000000425000000000000000000000000000041111111111111111111115
1111111111111111111111111111111111111111115000000041111111111111111111150000000000000000000000000000000000000000041150000000000411111111111111111111111111111111500000000415000000000000000000000000041111111115000000000000000000465000000000000000000000000000041111111111111111111115
1111111111111111111111111111111111111111115000000041111111111111111111150000000000000008333333333333333333333333341150000000000411111111111111111111111111111111500000000415000000000008333333333333341111111115333333700000000000000000000000000000000000000000041111111111111111111115
1111111111111111111111111111111111111111115000000041111111111111111111150000000000000004222222222222222222222222221150000000000411111111111111111111111111111111500000000415000000000004222222222222221111111112222222500000000000000000000000000000000000000000041111111111111111111115
1111111111111111111111111111111111111111115000000041111111111111111111150000000000000004111111111111111111111111111150000000000411111111111111111111111111111111500000000415000000000004666666111111111111111111111111500000000000000000000000000000000000000000041111111111111111111115
1111111111111111111111111111111111111111115000000041111111111111111111150000000000000004111111111111111111111111111150000000000411111111111111111111111111111111500000000415000000000000000000666666666666666666666666500000000000000000000000000000000000000000041111111111111111111115
1111111111111111111111111111111111111111115000000041111111111111111111150000000000000004111111111111111111111111111150000000000411111111111111111111111111111111533333333415000000000000000000000000000000000000000000000000000000000000000008370000000000000000041111111111111111111115
1111111111111111111111111111111111111111115000000041111111111111111111150000000000000004111111111111111111111111111150000000000411111111111111111111111111111111222222222215337000000000000000000000000000000000000000000000000000000000000004250000000000000000041111111111111111111115
1111111111111111111111111111111111111111115000000041111111111111111111153333333333333334111111111111111111111111111150000000000411111111111111111111111111111111566666666612225000000000000000000000000000000000000000000000000000000000000004650000000000000000041111111111111111111115
1111111111111111111111111111111111111111115000000041111111111111111111122222222222222222111111111111111111111111111150000000000411111111111111111111111111111111500000000066665000000000000083333333333333333333333333333700000000000000000000000083333333333333341111111111111111111115
1111111111111111111111111111111111111111115000000041111111111111111111111111111111111111111111111111111111111111111150000000000411111111111111111111111111111111500000000000000000000000000042222222222222222222222222222500000000000000000000000042222222222222221111111111111111111115
1111111111111111111111111111111111111111115000000041111111111111111111111111111111111111111111111111111111111111111150000000000411111111111111111111111111111111500000000000000000000000000046666666611111111111111111111500000000000000000000000041111111111111111111111111111111111115
1111111111111111111111111111111111111111115000000041111111111111111111111111111111111111111111111111111111111111111150000000000411111111111111111111111111111111500000000000000000000000000000000000041111111111111111111500000000000000000000000041111111111111111111111111111111111115
1111111111111111111111111111111111111111115000000041111111111111111111111111111111111111111111111111111111111111111150000000000411111111111111111111111111111111500000000000000000000000000000000000041111111111111111111533333333333333333333333341111111111111111111111111111111111115
1111111111111111111111111111111111111111115000000041111111111111111111111111111111111111111111111111111111111111111150000000000411111111111111111111111111111111500000000000000000000000000000000000041111111111111111111222222222222222222222222221111111111111111111111111111111111115
1111111111111111111111111111111111111111115000000041111111111111111111111111111111111111111111111111111111111111111150000000000411111111111111111111111111111111500000000000000000000837000000000000041111111111111111111111111111111111111111111111111111111111111111111111111111111115
1111111111111111111111111111111111111111115000000041111111111111111111111111111111111111111111111111111111111111111150000000000411111111111111111111111111111111500000000000000000000425000000000000041111111111111111111111111111111111111111111111111111111111111111111111111111111115
1111111111111111111111111111111111111111115000000041111111111111111111111111111111111111111111111111111111111111111150000000000411111111111111111111111111111111500000000000000000000465000000000000041111111111111111111111111111111111111111111111111111111111111111111111111111111115
6666666666666666666666666666666666666666665000000046666666666666666666666666666666666666666666666666666666666666666650000000000466666666666666666666666666666666500000000000000000000000000000000000046666666666666666666666666666666666666666666666666666666666666666666666666666666665