0000000000000000000000000000000000000000000000000000000000000000000000
0000000000000000000000000000000000000000000000000000000000000000000000
0000000000000000000000000000000000000000000000000000000000000000000000
0000000000000000000000000000000000000000000000000000000000000000000000
0000000000000000000000000000000000000000000000000000000000000000000000
0000000000000000000000000000000000000000000000000083333333333333333700
0000000000000000000000000000000000000000000000000042222222222222222500
0000000000000000000000000000000000000000000000000046666664111111111500
0000000000000000000000000000000000000000000000000000000004111111111500
0000000083333333333370000000000000000000000000000000000004111111111500
0000000042222222222250000000000000000000000000000000000004111111111500
0000000041111111111150000000000000000000000000000000000004111111111500
0000000041111111111150000000000000000000000000000000000004111111111500
0000000041111111111150000000000000000000000000000000000004111111111500
0083333341111111111150000000000000000000000000000000000004111111111500
0042222221111111111150000000000000000000000000000000000004111111111500
0041111111111111111150000000000000000000000000000000000004111111111500
3341111111111111111150000000000000000000000000000000000004111111111500
2221111111111111111150000000000000000000000000000000837004111111111500
1111111111111111111150000000000000000000000000000000425004111111111500
1111111111111111111150000000083333333333333333333333415004111111111500
1111111111111111111150000000042222222222222222222222215004111111111500
1111111111111111111150000000041666666666666666666666665004111111111500
1111111111111111111150000000041500000000000000000000000004111111111500
1111111111111111111150000000041500000000000000000000000004111111111500
1111111111111111111150000000041500000000000000000000000004111111111500
1111111111111111111150000000041500000000000000000000000004111111111500
1111111111111111111150000000041500000000000833333333333334111111111533
1111111111111111111150000000041500000000000422222222222222111111111222
1111111111111111111150000000041500000000000466666611111111111111111111
1111111111111111111150000000041500000000000000000066666666666666666666
1111111111111111111153333333341500000000000000000000000000000000000000
1111111111111111111122222222221533700000000000000000000000000000000000
1111111111111111111156666666661222500000000000000000000000000000000000
1111111111111111111150000000006666500000000000008333333333333333333333
1111111111111111111150000000000000000000000000004222222222222222222222
1111111111111111111150000000000000000000000000004666666661111111111111
1111111111111111111150000000000000000000000000000000000004111111111111
1111111111111111111150000000000000000000000000000000000004111111111111
1111111111111111111150000000000000000000000000000000000004111111111111
1111111111111111111150000000000000000000083700000000000004111111111111
1111111111111111111150000000000000000000042500000000000004111111111111
1111111111111111111150000000000000000000046500000000000004111111111111
6666666666666666666650000000000000000000000000000000000004666666666666