0000000000000000000000000000000000000000000000000000000000000000000000
0000000000000000000000000000000000000000000000000000000000000000000000
0000000000000000000000000000000000000000000000000000000000000000000000
0000000000000000000000000000000000000000000000000000000000000000000000
0000000000000000000000000000000000000000000000083333333333333333333337
0000000000000000000000000000000000000000000000042222222222222222222225
0000000000000000000000000000000000000000000000041111111111111111111115
0000000000000000000000000000000008370000000000041111111111111111111115
0000000000000000000000000000000004250000000000041111111111111111111115
0000000000000000000000000000000004650000000000041111111111111111111115
0000000000000000000000000000000000000000000000041111111111111111111115
0000000000000000000000000000000000000000000000041111111111111111111115
0000000000000000000837000000000000000000000000041111111111111111111115
0000000000000000000425000000000000000000000000041111111111111111111115
0000000000000000000465000000000000000000000000041111111111111111111115
0000000000000000000000000000000000000000000000041111111111111111111115
0000000000000000000000000000000000000000000000041111111111111111111115
0000000000000000000000000000000000000000000000041111111111111111111115
0000000837000000000000000000000000000000000000041111111111111111111115
0000000425000000000000000000000000000000000000041111111111111111111115
0000000465000000000000000000000000000000000000041111111111111111111115
0000000000000000000000000000000000000000000000041111111111111111111115
0000000000000000000000000000000000000000000000041111111111111111111115
0000000000000000000000000000000000000000000000041111111111111111111115
0000000000000000837000000000000000000000000000041111111111111111111115
0000000000000000425000000000000000000000000000041111111111111111111115
0000000000000000465000000000000000000000000000041111111111111111111115
3333700000000000000000000000000000000000000000041111111111111111111115
2222500000000000000000000000000000000000000000041111111111111111111115
1111500000000000000000000000000000000000000000041111111111111111111115
6666500000000000000000000000000000000000000000041111111111111111111115
0000000000000000000000000008370000000000000000041111111111111111111115
0000000000000000000000000004250000000000000000041111111111111111111115
0000000000000000000000000004650000000000000000041111111111111111111115
3333333700000000000000000000000083333333333333341111111111111111111115
2222222500000000000000000000000042222222222222221111111111111111111115
1111111500000000000000000000000041111111111111111111111111111111111115
1111111500000000000000000000000041111111111111111111111111111111111115
1111111533333333333333333333333341111111111111111111111111111111111115
1111111222222222222222222222222221111111111111111111111111111111111115
1111111111111111111111111111111111111111111111111111111111111111111115
1111111111111111111111111111111111111111111111111111111111111111111115
1111111111111111111111111111111111111111111111111111111111111111111115
6666666666666666666666666666666666666666666666666666666666666666666665