00000000000000083337
00000000000000042225
00000000000000041115
37000000000000046665
25000000000000000000
15000000000000000000
65000000000000000000
00000000000000000000
00000000000000000000
33700000000000000000
22500000000000000000
11500000000000000000
11533333333333333333
11222222222222222222
11111111111111111111
11111111111111111111
11111111111111111111
11111111111111111111
11111111111111111111
11111111111111111111
11111111111111111111
11111111111111111111
11111111111111111111
11111111111111111111
11111111111111111111
11111111111111111111
11111111111111111111
11111111111111111111
11111111111111111111
11111111111111111111
11111111111111111111
11111111111111111111
11111111111111111111
11111111111111111111
11111111111111111111
11111111111111111111
11111111111111111111
11111111111111111111
11111111111111111111
11111111111111111111
11111111111111111111
11111111111111111111
11111111111111111111
66666666666666666666