00000000000000000000
00000000000000000000
00000000000000000000
00000008333370000000
00000004222250000000
00000004111150000000
00000004111150000000
00000004111150000000
00000004111150000000
00000004111150000000
00000004111150000000
00000004111150000000
33333334111150000000
22222222111150000000
11111111111150000000
11111111111150000000
11111111111150000000
11111111111150000000
11111111111150000000
11111111111150000000
11111111111150000000
11111111111150000000
11111111111150000000
11111111111150000000
11111111111150000000
11111111111150000000
11111111111150000000
11111111111150000000
11111111111150000000
11111111111150000000
11111111111150000000
11111111111150000000
11111111111150000000
11111111111150000000
11111111111150000000
11111111111150000000
11111111111150000000
11111111111150000000
11111111111150000000
11111111111150000000
11111111111150000000
11111111111150000000
11111111111150000000
66666666666650000000