00000000000000000000
00000000000000000000
00000000000000000000
00000000000000000000
00000000000000000000
00000000000000000000
00000000000000000000
00000000000000000000
00000000000000000000
00833333333380000000
00422222222250000000
00411111111150000000
00411111111153333370
00411111111122222250
00411111111111111150
00466666666666666650
00000000000000000000
00000000000000000000
00000000000000000000
00000000000000000000
00000000000000000000
00000000000000000000
83333333333333333333
42222222222222222222
41111111111111111111
41111111111111111111
41111111111111111111
41111111111111111111
41111111111111111111
41111111111111111111
41111111111111111111
41111111111111111111
41111111111111111111
41111111111111111111
41111111111111111111
41111111111111111111
41111111111111111111
41111111111111111111
41111111111111111111
41111111111111111111
41111111111111111111
41111111111111111111
41111111111111111111
46666666666666666666