00000000000000000000
00000000000000000000
00000000000000000000
00000000000000000000
00000000000000000000
00000000000000000000
00000000000000000000
00000000000000000000
00000000000000000000
00000000000000000000
00000000000000000000
00000000000000000000
00000000000000000000
00000000000000000000
00000000000000000000
00000000000000000000
00000000000083800000
00000000000042500000
00000000000046500000
00000000000000000000
00000000000000000083
00000000000000000042
37000000000000000046
25000000000000000000
15000000000000000000
15000000000000000000
15000000000000000000
15000000000000000833
15000000000000000422
15000000000000000411
15000000000000000411
15000000000000000411
15000000000000000411
15333333333333333411
12222222222222222211
11111111111111111111
11111111111111111111
11111111111111111111
11111111111111111111
11111111111111111111
11111111111111111111
11111111111111111111
11111111111111111111
66666666666666666666