000000000000000000000000000000000000000000000000000000000000000000000000000000000000000000000000000000000000000000000000000000000000000000000000000000000000000000000000000000000000000000000000000000000000000000000000000000000000000000000000000000000083333333337
000000000000000000000000000000000000000000000000000000000000000000000000000000000000000000000000000000000000000000000000000000000000000000000000000000000000000000000000000000000000000000000000000000000000000000000000000000000000000000000000000000000042222222225
000000000000000000000000000000000000000000000000000000000000000000000000000000000000000000000000000000000000000000000000000000000000000000000000000000000000000000000000000000000000000000000000000000000000000000000000000000000000000000000000000000000041111111115
000000000000000000000000000000000000000000000000000000000000000000000000000000000000000000000000000000000000000000000000000000000000000000000000000000000000000000000000000000000000000000000000000000000000000000000000000000000000000000000000000000000041111111115
000000000000000000000000000000000000000000000000000000000000000000000000000000000000000000000000000000000000000000000000000000000000000000000000000000000000000000000000000000000000000000000000000000000000000000000000000000000000000000000000000000000041111111115
000000000000000000000000000000000000000000000000000000000000000000000000000000000000000000000000000000000000000000000000000000000000000000000000000000000000000000000000000000000000000000000000000000000000000000000000000000000000000000000000000000000041111111115
000000000000000000000000000000000000000000000000000000000000000000000000000000000000000000000000000000000000000000000000000000000000000000000000000000000000000000000000000000000000000000000000000000000000000000000000000000000000000000000000000000000041111111115
000000000000000000000000000000000000000000000000000000000000000000000000000000000000000000000000000000000000000000000000000000000000000000000000000000000000000000000000000000000000000000000000000000000000000000000000000000000000000000000000000000000041111111115
000000000000000000000000000000000000000000000000000000000000000000000000000000000000000000000000000000000000000000000000000000000000000000000000000000000000000000000000000000000000000000000000000000000000000000000000000000000000000000000000000000000041111111115
000000000000000000000000000000000000000000000000000000000000000000000000000000000000000000000000000000000000000000000000000000000000000000000000000000000000000000000000000000000000000083333333333333333333333333333333333333333333333333333333333333333343333333335
000000000000000000000000000000000000000000000000000000000000000000000000000000000000000000000000000000000000000008337000000000000000000000000000000000000000000000000000000000000000000042222222222222222222222222222222222222222222222222222222222222222222222222225
000000000000000000000000000000000000000000000000000000000000000000000000000000000000000000000000000000000000000004225000000000000000000000000000000000000000000000000000000000000000000041111111111111111111111111111111111111111111111111111111111111111111111111115
000000000000000000000000000000000000000000000000000000833700000000000000000000000000000000000000833700000000000004115000000000000000000000000000000000000000000000000000000000000000000046666611111111111111111111111111111111111111111111111111111111111111111111115
000000000000000000000000000000000000000000000000000000422500000000000000000000000000000000000000422500000000000004115000000000000000000000000000000000000000000000000000000000000000000000000411111111111111111111111111111111111111111111111111111111111111111111115
333333333333333333333333333333333333333333370000000000411500000000008337000000000083370000000000411500000000000004115000000000000000000000000000000000000000000000000000000000000000000000000411111111111111111111111111111111111111111111111111111111111111111111115
222222222222222222222222222222222222222222250000000000411500000000004225000000000042250000000000411500000000000004115000000000000000000000000000000000000000000000000000000000000000000000000411111111111111111111111111111111111111111111111111111111111111111111115
111111111111111111111111111111111111111111153333333333411533333333334115333333333341153333333333411500000000000004115000000833333333370000000000000000008333333333370000000000000083333333333411111111111111111111111111111111111111111111111111111111111111111111115
111111111111111111111111111111111111111111122222222222211222222222222112222222222221122222222222211500000000000004115000000422222222250000000000000000004222222222250000000000000042222222222211111111111111111111111111111111111111111111111111111111111111111111115
111111111111111111111111111111111111111111111111111111111111111111111111111111111111111111111111111500000000000004115333333411111111150000000000000000004111111111150000000000000041111111111111111111111111111111111111111111111111111111111111111111111111111111115
111111111111111111111111111111111111111111111111111111111111111111111111111111111111111111111111111500000000000004112222222211111111150000000083370000004666666111153333333333333341111111111111111111111111111111111111111111111111111111111111111111111111111111115
111111111111111111111111111111111111111111111111111111111111111111111111111111111111111111111111111500000000000004111111111111111111150000000042250000000000004111122222222222222221111111111111111111111111111111111111111111111111111111111111111111111111111111115
111111111111111111111111111111111111111111111111111111111111111111111111111111111111111111111111111500000000000004111111111111111111150000000041150000000000004111111111111111111111111111111111111111111111111111111111111111111111111111111111111111111111111111115
111111111111111111111111111111111111111111111111111111111111111111111111111111111111111111111111111500000000000004111111111111111111150000000046650000000000004111111111111111111111111111111111111111111111111111111111111111111111111111111111111111111111111111115
111111111111111111111111111111111111111111111111111111111111111111111111111111111111111111111111111500000000000004111111111111111111150000000000000000000000004111111111111111111111111111111111111111111111111111111111111111111111111111111111111111111111111111115
111111111111111111111111111111111111111111111111111111111111111111111111111111111111111111111111111500000000000004111111111111111111150000000000000000000000004111111111111111111111111111111111111111111111111111111111111111111111111111111111111111111111111111115
111111111111111111111111111111111111111111111111111111111111111111111111111111111111111111111111111500000000000004111111111111111111150000000000000000000000004111111111111111111111111111111111111111111111111111111111111111111111111111111111111111111111111111115
111111111111111111111111111111111111111111111111111111111111111111111111111111111111111111111111111500000000000004111111111111111111150000000000000000000000004111111111111111111111111111111111111111111111111111111111111111111111111111111111111111111111111111115
111111111111111111111111111111111111111111111111111111111111111111111111111111111111111111111111111500000000000004111111111111111111150000000000000000008333334111111111111111111111111111111111111111111111111111111111111111111111111111111111111111111111111111115
111111111111111111111111111111111111111111111111111111111111111111111111111111111111111111111111111500000000000004166666666666666666650000000000000000004222222111111111111111111111111111111111111111111111111111111111111111111111111111111111111111111111111111115
111111111111111111111111111111111111111111111111111111111111111111111111111111111111111111111111111500000000000004150000000000000000000000000000000000004111111111111111111111111111111111111111111111111111111111111111111111111111111111111111111111111111111111115
111111111111111111111111111111111111111111111111111111111111111111111111111111111111111111111111111500000000000004150000000000000000000000000000000000004666661111111111111111111111111111111111111111111111111111111111111111111111111111111111111111111111111111115
111111111111111111111111111111111111111111111111111111111111111111111111111111111111111111111111111500000000000004150000000000000000000000000000000000000000004111111111111111111111111111111111111111111111111111111111111111111111111111111111111111111111111111115
111111111111111111111111111111111111111111111111111111111111111111111111111111111111111111111111111500000000000004150000000000000000000000000000833700000000004111111111111111111111111111111111111111111111111111111111111111111111111111111111111111111111111111115
111111111111111111111111111111111111111111111111111111111111111111111111111111111111111111111111111500000000000004150000000000000000000000000000422500000000004111111111111111111111111111111111111111111111111111111111111111111111111111111111111111111111111111115
111111111111111111111111111111111111111111111111111111111111111111111111111111111111111111111111111500000000000004150000000000000000000000000000411500000000004111111111111111111111111111111111111111111111111111111111111111111111111111111111111111111111111111115
111111111111111111111111111111111111111111111111111111111111111111111111111111111111111111111111111500000000000004153333333333333333337000000000466500000000004111111111111111111111111111111111111111111111111111111111111111111111111111111111111111111111111111115
111111111111111111111111111111111111111111111111111111111111111111111111111111111111111111111111111500000000000004122222222222222222225000000000000000000000004111111111111111111111111111111111111111111111111111111111111111111111111111111111111111111111111111115
111111111111111111111111111111111111111111111111111111111111111111111111111111111111111111111111111500000000000004111111111111111111115000000000000000000000004111111111111111111111111111111111111111111111111111111111111111111111111111111111111111111111111111115
111111111111111111111111111111111111111111111111111111111111111111111111111111111111111111111111111500000000000004111111111111111111115000000000000000000000004111111111111111111111111111111111111111111111111111111111111111111111111111111111111111111111111111115
111111111111111111111111111111111111111111111111111111111111111111111111111111111111111111111111111500000000000004111111111111111111115000000000000000000000004111111111111111111111111111111111111111111111111111111111111111111111111111111111111111111111111111115
111111111111111111111111111111111111111111111111111111111111111111111111111111111111111111111111111500000000000004111111111111111111115000000000000000000000004111111111111111111111111111111111111111111111111111111111111111111111111111111111111111111111111111115
111111111111111111111111111111111111111111111111111111111111111111111111111111111111111111111111111500000000000004111111111111111111115000000000000000000000004111111111111111111111111111111111111111111111111111111111111111111111111111111111111111111111111111115