00000000008333333337
00000000004222222225
00000000004111111115
00000000004111111115
00000000004111111115
00000000004111111115
00000000004111111115
00000000004111111115
00000000004111111115
33333333334111111115
22222222222111111115
11111111111111111115
11111111111111111115
11111111111111111115
11111111111111111115
11111111111111111115
11111111111111111115
11111111111111111115
11111111111111111115
11111111111111111115
11111111111111111115
11111111111111111115
11111111111111111115
11111111111111111115
11111111111111111115
11111111111111111115
11111111111111111115
11111111111111111115
11111111111111111115
11111111111111111115
11111111111111111115
11111111111111111115
11111111111111111115
11111111111111111115
11111111111111111115
11111111111111111115
11111111111111111115
11111111111111111115
11111111111111111115
11111111111111111115
11111111111111111115
11111111111111111115