00000000000000000000
00000000000000000000
00000000000000000000
00000000000000000000
00000000000000000000
00000000000000000000
00000000000000000000
00000000000000000000
00000000000000000000
00000000000000000000
00000000000000000000
00000000000000000000
00000000000000008337
00000000000000004225
00833700000000004115
00422500000000004115
33411533333333334115
22211222222222222115
11111111111111111115
11111111111111111115
11111111111111111115
11111111111111111115
11111111111111111115
11111111111111111115
11111111111111111115
11111111111111111115
11111111111111111115
11111111111111111115
11111111111111111115
11111111111111111115
11111111111111111115
11111111111111111115
11111111111111111115
11111111111111111115
11111111111111111115
11111111111111111115
11111111111111111115
11111111111111111115
11111111111111111115
11111111111111111115
11111111111111111115
11111111111111111115