00000000000000000000
00000000000000000000
00000000000000000000
00000000000000000000
00000000000000000000
00000000000000000000
00000000000000000000
00000000000000000000
00000000000000000000
00000000000000000000
00000000000008337000
00000000000004225000
00000000000004115000
00000000000004115000
00000000000004115000
00000000000004115000
00000000000004115000
00000000000004115000
00000000000004115333
00000000000004112222
00000000000004111111
00000000000004111111
00000000000004111111
00000000000004111111
00000000000004111111
00000000000004111111
00000000000004111111
00000000000004111111
00000000000004166666
00000000000004150000
00000000000004150000
00000000000004150000
00000000000004150000
00000000000004150000
00000000000004150000
00000000000004153333
00000000000004122222
00000000000004111111
00000000000004111111
00000000000004111111
00000000000004111111
00000000000004111111