00000000000000000000
00000000000000000000
00000000000000000000
00000000000000000000
00000000000000000000
00000000000000000000
00000000000000000000
00000000000000000000
00000000000000000000
00000000000000000000
00000000000000000000
00000000000000000000
00000000000000000000
00000000000000000000
00000000000000000000
00000000000000000000
00083333333337000000
00042222222225000000
33341111111115000000
22221111111115000000
11111111111115000000
11111111111115000000
11111111111115000000
11111111111115000000
11111111111115000000
11111111111115000000
11111111111115000000
11111111111115000000
66666666666665000000
00000000000000000000
00000000000000000000
00000000000000000000
00000000000000000000
00000000000000000000
00000000000000000000
33333333333333700000
22222222222222500000
11111111111111500000
11111111111111500000
11111111111111500000
11111111111111500000
11111111111111500000