00000000000000000000
00000000000000000000
00000000000000000000
00000000000000000000
00000000000000000000
00000000000000000000
00000000000000000000
00000000000000000000
00000000000000000000
00000000000000000000
00000000000000000000
00000000000000000000
00000000000000000000
00000000000000000000
00000000000000000000
00000000000000000000
00000000000083333333
00000000000042222222
00000000000041111111
00833700000046666661
00422500000000000041
00411500000000000041
00466500000000000041
00000000000000000041
00000000000000000041
00000000000000000041
00000000000000000041
00000000000083333341
00000000000042222221
00000000000041111111
00000000000046666611
00000000000000000041
00008337000000000041
00004225000000000041
00004115000000000041
00004665000000000041
00000000000000000041
00000000000000000041
00000000000000000041
00000000000000000041
00000000000000000041
00000000000000000041