000000000000000000000000000000
000000000000000000000000000000
000000000000000000000000000000
000000000000000000000000000000
000000022222000000000000000000
000000000000000000000000000000
220000000000000002200002200000
112222222222222221100221120000
111111111111111111100111110000
111111111111111111100011000000
111111111111111111100010000000
111111111111111111100010000000
111111111111111111100000000000