000000000000000000000000000000000000000000000000000000000000
000000000000000000000000000000000000000000000000000000000000
000000000000000000000000000000000000000000000000000000000000
000000000000000000000000000000000000000000000000000000000000
000000022222000000000000000000000000022222000000000000000000
000000000000000000000000000000000000000000000000000000000000
220000000000000002200002200000000000000000000000000000000000
112222222222222221100221120022222222222222222220022222000000
111111111111111111100111110011111111111111111110011111000000
111111111111111111100011000011111111111111111110001100000000
111111111111111111100010000011111111111111111110001000000000
111111111111111111100010000011111111111111111110001000000000
111111111111111111100000000011111111111111111110000000000000