0000000000000000000000000000000000000000000000000000000000000000000000000000000000000000000000000000000000000000000000000000000006360000000000000000000000000000000000000000000000000000000000000000000000000000000000000000000000000000000000000000
0000000000000000000000000000000000000000000000000000000000000000000000000000000000000000000000000000000000000000000000000000000000000000000000000000000000000000000000000000000000000000000000000000000000000000000000000000000000000000000000000000
0000000000000000000000000000000000000000000000000000000000000000000000000000000000000000000000000000000000036300000000000000000000000000000000000000000000000000000000000000000000000000000000000000000000000000000000000000000000000000000000000000
0000000000000000000000000000000000000000000000000000000011111111111111111111111000000000000000000011111111163611111113000000000000000000031111110000000000000000000000000000000000000000000000000000000000000000000000036336631111111111111111111111
0000000000000000000000000000000000000000000000000000000022222222222222222222222000000000001100000022222222222222222223000000000000000000032222260000000000000000000000000000000000000000000000000000000000300000000000062222222222222222222222222222
0000000000000000000000000000000000000000000000000000000022222222222220000000000000000000000000000022222222222222222223366666666633333663332222230000000000000000000000000000000000000000000000000000000000000000000000062222222222222222222222222222
0000000000000000000000000000000000000000000000000000000022222222222220000000000000000000000000000022222222222222222222222222222222222222222222230000000330000000000000000000000000000000000000000000000000000000000060062222222222222222222222222222
0000000000000000000000000000000000000000000000000000000022222222222220000000000000000000000000000022222222222222222222222222222222222222222222260000000000000000000000000000000000000000000000000000000000000000000000062222222222222222222222222222
0000000000000000000000000000000000000000000000000000000022222222222220000000000000000100000000000022222222222222222222222222222222222222222222260000000000000000000000000000000000000000000000000000030000000000000000062222222222222222222222222222
0000000000000000000000000000000000000000000000000000000044444444444440000000000000000000000000000044444444444222222222222222222222222222222222230000000000660000000000000000000000000000000000000000000000000000000000062222222222222222222222222222
0000000000000000000000000000000000000000000000000000000000000000000000000000000000000000000000000000000000000222222222222222222222222222222222260000000000000000000600000000000000000000000000000000000000000000000000062222222222222222222222222222
0000000000000000000000000000000000000000000000000000000000000000000000000000000000000000000110000000000000000222222222222222222222222222222222230000000000000000000000000000000000000000000000000000000000060000000000032222222222222222222222222222
0000000000000000000000000000000000000000000000000000000000000000000000000000000000000000000000000000000000000222222222222222222222222222222222260000000000000000000000000000000000000000000000000000060000000000000000032222222222222222222222222222
0000000000000000000000000000000000000000000000000000000011111111111110000000000000000000000000000100000001111222222222222222222222222222222222230000000000000000000000000000000000000000000000000000000000000000003000032222222222222222222222222222
0000000000000000000000000000000000000000000000000000000022222222222220000000111100000000000000000000000002222222222222222222222222222222222222230000000000000000000000000000000000000000000000000600000000000000000000062222222222222222222222222222
0000000000000000000000000000000000000111110000000000000022222222222220000000000000000000000001100000000002222222222222222222222222222222222222230000000000000000000000000330000000000000000000000000000000000000000060032222222222222222222222222222
1111111111111111111111111000000000000000000000111111111122222222222220000000000000000000110000000000000002222222222222222222222222222222222222230000000000000000000000000000000000000000000000000000000000000006000000032222222222222222222222222222
2222222222222222222222222000000000000000000000222222222222222222222220000000000000000000000000000000000002222222222222222222222222222222222222230000000000000000000000000000000000000000000000000000000000000000000000032222222222222222222222222222
2222222222222222222222222000000000000000000000222222222222222222222220000000000000000000000000000000000002222222222222222222222222222222222222260000000000000000360000000000000000000000000000000000000000030000000000032222222222222222222222222222
2222222222222222222222222111111111111111111111222222222222222222222220000000000000000000000000000000000002222222222222222222222222222222222222230000000000000000000000000000000000000000000000000000000000000000000000062222222222222222222222222222
2222222222222222222222222222222222222222222222222222222222222222222220000000000000000000000000000000000002222222222222222222222222222222222222230000000000000000000000000366366363663636366000000000000060000000000000032222222222222222222222222222
2222222222222222222222222222222222222222222222222222222222222222222220000000000000000000000000000000000002222222222222222222222222222222222222230000000000000000000000000555555555555555555000000630000000000000000000032222222222222222222222222222
2222222222222222222222222222222222222222222222222222222222222222222220000000000000000000000000000000000002222222222222222222222222222222222222260000000000000000000000000555555555555555555000000000000000000000000000032222222222222222222222222222
2222222222222222222222222222222222222222222222222222222222222222222220000000000000000000000000000000000002222222222222222222222222222222222222260000000000000000000000000555555555555555555000000000000000000000000000062222222222222222222222222222
2222222222222222222222222222222222222222222222222222222222222222222220000000000000000000000000000000000002222222222222222222222222222222222222230000000000000000000000000555555555555555555000000000000000000000000000032222222222222222222222222222
2222222222222222222222222222222222222222222222222222222222222222222220000000000000000000000000000000000002222222222222222222222222222222222222230000000000000000000000000555555555555555555000000000000000000000000000032222222222222222222222222222
2222222222222222222222222222222222222222222222222222222222222222222220000000000000000000000000000000000002222222222222222222222222222222222222230000000000000000000000000555555555555555555000000000000000000000000000062222222222222222222222222222
2222222222222222222222222222222222222222222222222222222222222222222220000000000000000000000000000000000002222222222222222222222222222222222222230000000000000000000000000000000000000000000000000000000000000000000000062222222222222222222222222222