000000000000
000000000000
630000000000
361111300000
222222300000
222222336666
222222222222
222222222222
222222222222
422222222222
022222222222
022222222222
022222222222
122222222222
222222222222
222222222222
222222222222
222222222222
222222222222
222222222222
222222222222
222222222222
222222222222
222222222222
222222222222
222222222222
222222222222
222222222222