000000636000
000000000000
000000000000
000000000000
000000000000
666663333366
222222222222
222222222222
222222222222
222222222222
222222222222
222222222222
222222222222
222222222222
222222222222
222222222222
222222222222
222222222222
222222222222
222222222222
222222222222
222222222222
222222222222
222222222222
222222222222
222222222222
222222222222
222222222222