000000000000
000000000000
000000000000
003111110000
003222260000
333222230000
222222230000
222222260000
222222260000
222222230000
222222260000
222222230000
222222260000
222222230000
222222230000
222222230000
222222230000
222222230000
222222260000
222222230000
222222230000
222222230000
222222260000
222222260000
222222230000
222222230000
222222230000
222222230000