000000000000
000000000000
000000000000
000000000000
000000000000
000000000000
000000000000
000000000000
000000000000
000000000000
000600000000
000000000000
000000000000
000000000000
000000000000
000000000330
000000000000
000000000000
360000000000
000000000000
000000000366
000000000555
000000000555
000000000555
000000000555
000000000555
000000000555
000000000000