000000000000
000000000000
000000000000
000000000000
000000000000
000000000000
000000000000
000000000000
000000000000
000000000000
000000000000
000000000000
000000000000
000000000000
000000000600
000000000000
000000000000
000000000000
000000000000
000000000000
366000000000
555000000630
555000000000
555000000000
555000000000
555000000000
555000000000
000000000000