000000000000
000000000000
000000000000
000000036336
000000062222
000000062222
000060062222
000000062222
000000062222
000000062222
000000062222
000000032222
000000032222
003000032222
000000062222
000060032222
000000032222
000000032222
000000032222
000000062222
000000032222
000000032222
000000032222
000000062222
000000032222
000000032222
000000062222
000000062222