000000000000
000000000000
000000000000
631111111111
222222222222
222222222222
222222222222
222222222222
222222222222
222222222222
222222222222
222222222222
222222222222
222222222222
222222222222
222222222222
222222222222
222222222222
222222222222
222222222222
222222222222
222222222222
222222222222
222222222222
222222222222
222222222222
222222222222
222222222222