000000000000
000000000000
000000000000
000000000000
000000000000
000000000000
000000000000
000000000000
000000000000
000000000000
000000000000
000000000000
000000000000
000000000000
000000000000
000000000000
100000000000
200000000000
200000000000
211111111111
222222222222
222222222222
222222222222
222222222222
222222222222
222222222222
222222222222
222222222222