000000000000
000000000000
000000000000
000000000000
000000000000
000000000000
000000000000
000000000000
000000000000
000000000000
000000000000
000000000000
000000000000
000000000000
000000000000
011111000000
000000000011
000000000022
000000000022
111111111122
222222222222
222222222222
222222222222
222222222222
222222222222
222222222222
222222222222
222222222222