000000000000
000000000000
000000000000
000000001111
000000002222
000000002222
000000002222
000000002222
000000002222
000000004444
000000000000
000000000000
000000000000
000000001111
000000002222
000000002222
111111112222
222222222222
222222222222
222222222222
222222222222
222222222222
222222222222
222222222222
222222222222
222222222222
222222222222
222222222222