000000000000
000000000000
000000000000
111111111111
222222222222
222222222000
222222222000
222222222000
222222222000
444444444000
000000000000
000000000000
000000000000
111111111000
222222222000
222222222000
222222222000
222222222000
222222222000
222222222000
222222222000
222222222000
222222222000
222222222000
222222222000
222222222000
222222222000
222222222000