000000000000
000000000000
000000000003
001111111116
002222222222
002222222222
002222222222
002222222222
002222222222
004444444444
000000000000
000000000000
000000000000
010000000111
000000000222
000000000222
000000000222
000000000222
000000000222
000000000222
000000000222
000000000222
000000000222
000000000222
000000000222
000000000222
000000000222
000000000222