000000000000000000000000000000000000000000000000000000000000000000000000000000000000000000000000000004111000000000000000000000000000000000000000000000000000000000000000000000000000000000000000000000000000000000000000000000000000000000000000000000000000000000000000000000000000000000000000000000000000000000000000000000000000000000000000000000000000000000000000
000000000000000000000000000000000000000000000000000000000000000000000000000000000000000000000000000004111100000000000000000000000033333700000000000000000000000000000000000000000000000000000000000000000000000000000000000000000000000000000000000000000000000000000000000000000000000000000000000000000000000000000000000000000000000000000000000000000000000000000000
000000000000000000000000000000000000000000000000000000000000000000000000000000000000000000000000000004111111000000000000000000000011111500000000000000000000000000000000000000000000000000000000000000000000000000000000000000000000000000000000000000000000000000000000000000000000000000000000000000000000000000000000000000000000000000000000000000000000000000000000
000000000000000000000000000000000000000000000000000000000000000000000000000000000000000000000000000004111111110000000000000000001111111500000000000000000000000000000000000000000000000000000000000000000000000000000000000000000000000000000000000000000000000000000000000000000000000000000000000000000000000000000000000000000000000000000000000000000000000000000000
000000000000000000000000000000000000000000000000000000000000000000000000000000000000000000000000000004111111111100000000000000111111111500000000000000000000000000000000000000000000000000000000000000000000000000000000000000000000000000000000000000000000000000000000000000000000000000000000000000000000000000000000000000000000000000000000000000000000000000000000
000000000000000000000000000000000000000000000000000000000000000000000000000000000000000000000000000004111111111111000000000000111111111500000000000000000000000000000000000000000000000000000000000000000000000000000000000000000000000000000000000000000000000000000000000000000000000000000000000000000000000000000000000000000000000000000000000000000000000000000000
000000000000000000000000000000000000000000000000000000000000000000000000000000000000000000000000000004111111111111111000000111111111111500000000000000000000000000000000000000000000000000000000000000000000000000000000000000000000000000000000000000000000000000000000000000000000000000000000000000000000000000000000000000000000000000000000000000000000000000000000
333333333333333333333333333333333333333333333333333337000000000000000000000000000000000000000000000004111111111111111111111111111111111500000000000000000000000000000000083333700000000000000000000000000000000000000000000000000000000000000000000000000000000000000000000000000000000000000000000000000000000000000000000000000000000000000000000000000000000000000000
222222222222222222222222222222222222222222222222222225000000008333333370000000000000000000000000000004111111111111111111111111111111111500000000000000000008370000000000042222500000000000000000083333370000000000000000000000008337008333333700000000000000000000000000000000000000000000008333333333333333333333333333333700000000000000000000000000000000000000000000
411111111111111111111111111111111111111111111111111115000000004222222250000000000000000000000000000004111111111111111111111111111111111500000000000000000004250000000000046666500000000000000000042222250000000000000000000000004225004111111500000000000000000000000000000000000000000000004222222222222222222222222222222500000000000000000000000000000000000000000000
411111111111111111111111111111111111111111111111111115000000004111111150000000000000000000000000000004111111111111111111111111111111111500000000000000000004650000000000000000000000000000000000041111150000000000000000000000004115334111111500000000000000000000000000000000000000000000004111111111111111111111111111111500000000000000000000000000000000000000000000
411111111111111111111111111111111111111111111111111115000000004111111150000000000000000000000000000004111111111111111111111111111111111500000000000000000000000000000000000000000000000000000000041111150000000000000000000000004112222111111500000000000000000000000000000000000000000000004111111111111111111111111111111500000000000000000000000000000000000000000000
411111111111111111111111111111111111111111111111111115000000004111111150000000000000000000000000000004111111111111111111111111111111111500000000000000000000000000000000000000000000000000000000041111150000000000000000000000004111111111111500000000000000000000000000000000000000000000004111111111111111111111111111111500000000083333333333333333333333333333333337
411111111111111111111111111111111111111111111111111115000000004111111153333333333333333333333333370004111111111111111111111111111111111500000000000000000000000000000000000000000000000000000000041111153333333333333333333333334111111111111500000000008333333333333333333333333370000000004111111111111111111111111111111500000000042222222222222222222222222222222225
411111111111111111111111111111111111111111111111111115000000004111111122222222222222222222222222250004111111111111111111111111111111111500000000000000000000000000000000000000000000000000000833341111122222222222222222222222222111111111111500000000004222222222222222222222222250000000004111111111111111111111111111111500000000042222222222222222222222222222222225
411111111111111111111111111111111111111111111111111115000000004111111111111111111111111111111111150004111111111111111111111111111111111500000083700000000000000000000000000000000000000000000422221111111111111111111111111111111111111111111500000000004111111111111111111111111150000000004111111111111111111111111111111500000000042222222222222222222222222222222225
411111111111111111111111111111111111111111111111111115000000004111111111111111111111111111111111150004111111111111111111111111111111111500000042500000000000000000000000000000000000000000000411111111111111111111111111111111111111111111111500000000004111111111111111111111111150000000004111111111111111111111111111111500000000042222222222222222222222222222222225
411111111111111111111111111111111111111111111111111115000000004111111111111111111111111111111111150004111111111111111111111111111111111500000046500000000000008370000000000000000000000000000411111111111111111111111111111111111111111111111500000000004111111111111111111111111150000000004111111111111111111111111111111500000000042222222222222222222222222222222225
411111111111111111111111111111111111111111111111111115000000004111666666666666666666666666666666650004111111111111111111111111111111111500000000000000000000004250000000000000000000000000000411111111111111111111111111111111111111111111111500000000004111111111111111111111111150000000004111111111111111111111111111111500000000042222222222222222222222222222222225
411111111111111111111111111111111111111111111111111115000000004111500000000000000000000000000000000004111111111111111111111111111111111500000000000000000000004650000000000000000000000000000411111111111111111111111111111111111111111111111500000000004111111111111111111111111150000000004111111111111111111111111111111500000000042222222222222222222222222222222225
411111111111111111111111111111111111111111111111111115000000004111500000000000000000000000000000000004111111111111111111111111111111111500000000000000000000000000000000000000000000000000000411111111111111111111111111111111111111111111111500000000004111111111111111111111111150000000004111111111111111111111111111111500000000042222222222222222222222222222222225
411111111111111111111111111111111111111111111111111115000000004111500000000000000000000000000000000004111111111111111111111111111111111500000000000000000000000000000000000000000000000000000411111111111111111111111111111111111111111111111500000000004111111111111111111111111150000000004111111111111111111111111111111500000000042222222222222222222222222222222225
411111111111111111111111111111111111111111111111111115000000004111500000000000000000000000000000000004111111111111111111111111111111111533370000000000000000000000000000000000000000000000000411111111111111111111111111111111111111111111111500000000004111111111111111111111111150000000004111111111111111111111111111111500000000042222222222222222222222222222222225
411111111111111111111111111111111111111111111111111115000000004111500000000000000000000000000000000004111111111111111111111111111111111222253370000000000000000000000000008370000000000000000411111111111111111111111111111111111111111111111500000000004111111111111111111111111150000000004111111111111111111111111111111500000000042222222222222222222222222222222225
411111111111111111111111111111111111111111111111111115000000004111500083333333333333333333333370000004111111111111111111111111111111111111122253370000000000000000000000004250000000000000000411111111111111111111111111111111111111111111111500000000004111111111111111111111111150000000004111111111111111111111111111111500000000042222222222222222222222222222222225
411111111111111111111111111111111111111111111111111115000000004111500042222222222222222222222250000004111111111111111111111111111111111111111122253370000000000000000000004650000000000000000411111111111111111111111111111111111111111111111500000000004111111111111111111111111150000000004111111111111111111111111111111500000000042222222222222222222222222222222225
411111111111111111111111111111111111111111111111111115000000004111500041111111111111111111111150000004111111111111111111111111111111111111111111122250000000000000000000000000000000000000000411111111111111111111111111111111111111111111111500000000004111111111111111111111111150000000004111111111111111111111111111111500000000042222222222222222222222222222222225
411111111111111111111111111111111111111111111111111115000000004111500041111111111111111111111150000004111111111111111111111111111111111111111111111150000000000000000000000000000000000000833411111111111111111111111111111111111111111111111500000000004111111111111111111111111150000000004111111111111111111111111111111500000000042222222222222222222222222222222225
411111111111111111111111111111111111111111111111111115000000004111500041111111111111111111111153333334111111111111111111111111111111111111111111111150000000000000000000000000000000000837422211111111111111111111111111111111111111111111111500000000004111111111111111111111111150000000004111111111111111111111111111111500000000042222222222222222222222222222222225
411111111111111111111111111111111111111111111111111115000000004111500041111111111111111111111122222222111666666666666666666666666666666666666666666650000000000000000000000000000000000425411111111111111111111111111111111111111111111111111500000000004111111111111111111111111150000000004111111111111111111111111111111500000000042222222222222222222222222222222225
411111111111111111111111111111111111111111111111111115000000004111500041111111111111111111111111111111111500000000000000000000000000000000000000000000000000000000000000000000000000000465411111111111111111111111111111111111111111111111111500000000004111111111111111111111111150000000004111111111111111111111111111111500000000042222222222222222222222222222222225
411111111111111111111111111111111111111111111111111115000000004111500046666666666666666666666666666666666500000000000000000000000000000000000000000000000000000000000000000000000000000000411111111111111111111111111111111111111111111111111500000000004111111111111111111111111150000000004111111111111111111111111111111500000000042222222222222222222222222222222225
411111111111111111111111111111111111111111111111111115000000004111500000000000000000000000000000000000000000000000000000000000000000000000000000000000000000000000000000000000000000000000411111111111111111111111111111111111111111111111111500000000004111111111111111111111111150000000004111111111111111111111111111111500000000042222222222222222222222222222222225
411111111111111111111111111111111111111111111111111115000000004111500000000000000000000000000000000000000000000000000000000000000000000000000000000000000000000000000000000000000000000000411111111111111111111111111111111111111111111111111500000000004111111111111111111111111150000000004111111111111111111111111111111500000000042222222222222222222222222222222225
411111111111111111111111111111111111111111111111111115000000004111500000000000000000000000000000000000000000000000000000000000000000000000000000000000000000000000000000000000000000008370411111111111111111111111111111111111111111111111111500000000004111111111111111111111111150000000004111111111111111111111111111111500000000042222222222222222222222222222222225
411111111111111111111111111111111111111111111111111115000000004111500000000000000000000000000000000000000000000000000000000000000000000000000000000000000000000000000000000000000000004250411111111111111111111111111111111111111111111111111500000000004111111111111111111111111150000000004111111111111111111111111111111500000000042222222222222222222222222222222225
411111111111111111111111111111111111111111111111111115000000004111500000000000000000000000000000000000000000000000000000000000000000000000000000000000000000000000000000000000000000004650411111111111111111111111111111111111111111111111111500000000004111111111111111111111111150000000004111111111111111111111111111111500000000042222222222222222222222222222222225
411111111111111111111111111111111111111111111111111115000000004111500000000000000000000000000000000000000000000000000000000000000000000000000000000000000000000000000000000000000000000000411111111111111111111111111111111111111111111111111500000000004111111111111111111111111150000000004111111111111111111111111111111500000000042222222222222222222222222222222225
411111111111111111111111111111111111111111111111111115000000004111500000000000000000000000000000000000000000000000000000000000000000000000000000000000000000000000000000000000000000000000411111111111111111111111111111111111111111111111111500000000004111111111111111111111111150000000004111111111111111111111111111111500000000042222222222222222222222222222222225
411111111111111111111111111111111111111111111111111115000000004111500000000000000000000000000000000000000000000000000000000000000000000000000000000000000000000000000000000000000000000000411111111111111111111111111111111111111111111111111500000000004111111111111111111111111150000000004111111111111111111111111111111500000000042222222222222222222222222222222225
411111111111111111111111111111111111111111111111111115000000004111500000000000000000000000000000833333333333333333333333333333333333333333333333700000000000008333333333333333333333333333411111111111111111111111111111111111111111111111111500000000004111111111111111111111111150000000004111111111111111111111111111111500000000042222222222222222222222222222222225
411111111111111111111111111111111111111111111111111115000000004111500000000000000000000000000000422222222222222222222222222222222222222222222222500000000000004222222222222222222222222222211111111111111111111111111111111111111111111111111500000000004111111111111111111111111150000000004111111111111111111111111111111500000000042222222222222222222222222222222225
411111111111111111111111111111111111111111111111111115000000004111533333333333370000000000833333411111111111111111111111111111111111111111111111500000000000004111111111111111111111111111111111111111111111111111111111111111111111111111111500000000004111111111111111111111111150000000004111111111111111111111111111111500000000042222222222222222222222222222222225
411111111111111111111111111111111111111111111111111115000000004111222222222222250000000000422222211111111111111111111111111111111111111111111111500000000000004111111111111111111111111111111111111111111111111111111111111111111111111111111500000000004111111111111111111111111150000000004111111111111111111111111111111500000000042222222222222222222222222222222225
411111111111111111111111111111111111111111111111111115000000004111111111111111150000000000411111111111111111111111111111111111111111111111111111500000000000004111111111111111111111111111111111111111111111111111111111111111111111111111111500000000004111111111111111111111111150000000004111111111111111111111111111111500000000042222222222222222222222222222222225
411111111111111111111111111111111111111111111111111115000000004111111111111111150000000000411111111111111111111111111111111111111111111111111111500000000000004111111111111111111111111111111111111111111111111111111111111111111111111111111500000000004111111111111111111111111150000000004111111111111111111111111111111500000000042222222222222222222222222222222225
411111111111111111111111111111111111111111111111111115000000004111111111111111150000000000411111111111111111111111111111111111111111111111111111500000000000004111111111111111111111111111111111111111111111111111111111111111111111111111111500000000004111111111111111111111111150000000004111111111111111111111111111111500000000042222222222222222222222222222222225
466666666666666666666666666666666666666666666666666665000000004666666666666666650000000000466666666666666666666650000000466666666666666666666666500000000000004666666666666666666666666666666666666666666666666666666666666666666666666666665500000000004666666666666666666666666650000000004666666666666666666666666666666500000000046666666666666666666666666666666665