00000000000000000000
00000000000000000000
00000000000000000000
00000000000000000000
00000000000000000000
00000000000000000000
00000000000000000000
00000000000000000000
00000000000008333337
00000000000004222225
00000000000004111115
00000000000004111115
00000000000004111115
00000000000004111115
00000000083334111112
00000000042222111111
00000000041111111111
00000000041111111111
00000000041111111111
00000000041111111111
00000000041111111111
00000000041111111111
00000000041111111111
00000000041111111111
00000000041111111111
00000000041111111111
00000000041111111111
00000083341111111111
00083742221111111111
00042541111111111111
00046541111111111111
00000041111111111111
00000041111111111111
00000041111111111111
00837041111111111111
00425041111111111111
00465041111111111111
00000041111111111111
00000041111111111111
00000041111111111111
33333341111111111111
22222221111111111111
11111111111111111111
11111111111111111111
11111111111111111111
11111111111111111111
11111111111111111111
66666666666666666666