00000000000000000000
00000000000000000000
00000000000000000000
00000000000000000000
00000000000000000000
00000000000000000000
00000000000000000000
00000000000000000000
00008337008333333700
00004225004222222500
00004115334111111500
00004112222111111500
00004111111111111500
33334111111111111500
22222111111111111500
11111111111111111500
11111111111111111500
11111111111111111500
11111111111111111500
11111111111111111500
11111111111111111500
11111111111111111500
11111111111111111500
11111111111111111500
11111111111111111500
11111111111111111500
11111111111111111500
11111111111111111500
11111111111111111500
11111111111111111500
11111111111111111500
11111111111111111500
11111111111111111500
11111111111111111500
11111111111111111500
11111111111111111500
11111111111111111500
11111111111111111500
11111111111111111500
11111111111111111500
11111111111111111500
11111111111111111500
11111111111111111500
11111111111111111500
11111111111111111500
11111111111111111500
11111111111111111500
66666666666666665500