00000000000000000000
00000000000000000000
00000000000000000000
00000000000000000000
00000000000000000000
00000000000000000000
00000000000000000000
00000000000000000000
00000000000000000000
00000000000000000000
00000000000000000000
00000000000000000000
00000000000000000000
00000000833333333333
00000000422222222222
00000000411111111111
00000000411111111111
00000000411111111111
00000000411111111111
00000000411111111111
00000000411111111111
00000000411111111111
00000000411111111111
00000000411111111111
00000000411111111111
00000000411111111111
00000000411111111111
00000000411111111111
00000000411111111111
00000000411111111111
00000000411111111111
00000000411111111111
00000000411111111111
00000000411111111111
00000000411111111111
00000000411111111111
00000000411111111111
00000000411111111111
00000000411111111111
00000000411111111111
00000000411111111111
00000000411111111111
00000000411111111111
00000000411111111111
00000000411111111111
00000000411111111111
00000000411111111111
00000000466666666666