00000000000000000000
00000000000000000000
00000000000000000000
00000000000000000000
00000000000000000000
00000000000000000000
00000000000000000000
00000000000000000000
00000000000000000000
00000000000000000000
00000000000000000000
00000000000000000000
00000000000000000000
33333333333333700000
22222222222222500000
11111111111111500000
11111111111111500000
11111111111111500000
11111111111111500000
11111111111111500000
11111111111111500000
11111111111111500000
11111111111111500000
11111111111111500000
11111111111111500000
11111111111111500000
11111111111111500000
11111111111111500000
11111111111111500000
11111111111111500000
11111111111111500000
11111111111111500000
11111111111111500000
11111111111111500000
11111111111111500000
11111111111111500000
11111111111111500000
11111111111111500000
11111111111111500000
11111111111111500000
11111111111111500000
11111111111111500000
11111111111111500000
11111111111111500000
11111111111111500000
11111111111111500000
11111111111111500000
66666666666666500000