00000000000000000000
00000000000000000000
00000000000000000000
00000000000000000000
00000000000000000000
00000000000000000000
00000000000000000000
00000000000000000000
00008333333333333333
00004222222222222222
00004111111111111111
00004111111111111111
00004111111111111111
00004111111111111111
00004111111111111111
00004111111111111111
00004111111111111111
00004111111111111111
00004111111111111111
00004111111111111111
00004111111111111111
00004111111111111111
00004111111111111111
00004111111111111111
00004111111111111111
00004111111111111111
00004111111111111111
00004111111111111111
00004111111111111111
00004111111111111111
00004111111111111111
00004111111111111111
00004111111111111111
00004111111111111111
00004111111111111111
00004111111111111111
00004111111111111111
00004111111111111111
00004111111111111111
00004111111111111111
00004111111111111111
00004111111111111111
00004111111111111111
00004111111111111111
00004111111111111111
00004111111111111111
00004111111111111111
00004666666666666666