00000000000000000000
00000000000000000000
00000000000000000000
00000000000000000000
00000000000000000000
00000000000000000000
00000000000000000000
00000000000000000000
33333333333333370000
22222222222222250000
11111111111111150000
11111111111111150000
11111111111111150000
11111111111111150000
11111111111111150000
11111111111111150000
11111111111111150000
11111111111111150000
11111111111111150000
11111111111111150000
11111111111111150000
11111111111111150000
11111111111111150000
11111111111111150000
11111111111111150000
11111111111111150000
11111111111111150000
11111111111111150000
11111111111111150000
11111111111111150000
11111111111111150000
11111111111111150000
11111111111111150000
11111111111111150000
11111111111111150000
11111111111111150000
11111111111111150000
11111111111111150000
11111111111111150000
11111111111111150000
11111111111111150000
11111111111111150000
11111111111111150000
11111111111111150000
11111111111111150000
11111111111111150000
11111111111111150000
66666666666666650000