00000000000000000000
00000000000000000000
00000000000000000000
00000000000000000000
00000000000000000000
00000000000000000000
00000000000000000000
00000000000000000000
00000000000000000000
00000000000000000000
00000000000000000000
00000000000000000000
00000833333333333333
00000422222222222222
00000411111111111111
00000411111111111111
00000411111111111111
00000411111111111111
00000411111111111111
00000411111111111111
00000411111111111111
00000411111111111111
00000411111111111111
00000411111111111111
00000411111111111111
00000411111111111111
00000411111111111111
00000411111111111111
00000411111111111111
00000411111111111111
00000411111111111111
00000411111111111111
00000411111111111111
00000411111111111111
00000411111111111111
00000411111111111111
00000411111111111111
00000411111111111111
00000411111111111111
00000411111111111111
00000411111111111111
00000411111111111111
00000411111111111111
00000411111111111111
00000411111111111111
00000411111111111111
00000411111111111111
00000411111111111111