00000000000000000000
00000000000000000000
00000000000000000000
00000000000000000000
00000000000000000000
00000000000000000000
00000000000000000000
00000000000000000000
00000000000000000000
00000000000000000000
00000000000000000000
00000000000000000000
33333333333333333337
22222222222222222225
11111111111111111115
11111111111111111115
11111111111111111115
11111111111111111115
11111111111111111115
11111111111111111115
11111111111111111115
11111111111111111115
11111111111111111115
11111111111111111115
11111111111111111115
11111111111111111115
11111111111111111115
11111111111111111115
11111111111111111115
11111111111111111115
11111111111111111115
11111111111111111115
11111111111111111115
11111111111111111115
11111111111111111115
11111111111111111115
11111111111111111115
11111111111111111115
11111111111111111115
11111111111111111115
11111111111111111115
11111111111111111115
11111111111111111115
11111111111111111115
11111111111111111115
11111111111111111115
11111111111111111115
11111111111111111115