00000000000000000000
00000000000000000000
00000000000000000000
00000000000000000000
00000000000000000000
00000000000000000000
00000000000000000000
33333333333337000000
22222222222225000000
11111111111115000000
11111111111115000000
11111111111115000000
11111111111115000000
11111111111115000000
11111111111115000000
11111111111115000000
11111111111115000000
11111111111115000000
11111111111115000000
11111111111115000000
11111111111115000000
11111111111115000000
11111111111115000000
11111111111115000000
11111111111115000000
11111111111115000000
11111111111115000000
11111111111115000000
11111111111115000000
11111111111115000000
11111111111115000000
11111111111115000000
11111111111115000000
11111111111115000000
11111111111115000000
11111111111115000000
11111111111115000000
11111111111115000000
11111111111115000000
11111111111115000000
11111111111115000000
11111111111115000000
11111111111115000000
11111111111115000000
11111111111115000000
11111111111115000000
11111111111115000000
66666666666665000000