00000000000000000000
00000000000000000000
00000000000000000000
00000000000000000000
00000000000000000000
00000000000000000000
00000000000000000000
00000000000000000000
00833333337000000000
00422222225000000000
00411111115000000000
00411111115000000000
00411111115000000000
00411111115333333333
00411111112222222222
00411111111111111111
00411111111111111111
00411111111111111111
00411166666666666666
00411150000000000000
00411150000000000000
00411150000000000000
00411150000000000000
00411150000000000000
00411150008333333333
00411150004222222222
00411150004111111111
00411150004111111111
00411150004111111111
00411150004111111111
00411150004111111111
00411150004666666666
00411150000000000000
00411150000000000000
00411150000000000000
00411150000000000000
00411150000000000000
00411150000000000000
00411150000000000000
00411150000000000000
00411150000000000000
00411150000000000000
00411153333333333337
00411122222222222225
00411111111111111115
00411111111111111115
00411111111111111115
00466666666666666665