00000000000000000000
00000000000000000000
00000000000000000000
00000000000000000000
00000000000000000000
00000000000000000000
00000000000000000000
00000000000000000000
00000000000000000000
00000000000000000000
00000000000000000000
00000000000000000000
00000000000000000000
33333333333333333700
22222222222222222500
11111111111111111500
11111111111111111500
11111111111111111500
66666666666666666500
00000000000000000000
00000000000000000000
00000000000000000000
00000000000000000000
00000000000000000000
33333333333333700000
22222222222222500000
11111111111111500000
11111111111111500000
11111111111111533333
11111111111111222222
11111111111111111111
66666666666666666666
00000000000000000000
00000000000000000000
00000000000000000000
00000000000000000000
00000000000000000000
00000000000000000000
00000000000000000000
00000000000000000000
00000000000000008333
00000000000000004222
00000000008333334111
00000000004222222111
00000000004111111111
00000000004111111111
00000000004111111111
00000000004666666666