08333370000000000000
04222253700000000000
04111122537000000000
04111111115337000000
04111111112225000000
04111111111115333700
04111111111112222533
04111111111111111222
04111111111111111111
04111111111111111111
04111111111111111111
04111111111111111111
04111111111111111111
04111111111111111111
04111111111111111111
04111111111111111111
04111111111111111111
04111111111111111111
04111111111111111111
04111111111111111111
04111111111111111111
04111111111111111111
04111111111111111111
04111111111111111111
04111111111111111111
04111111111111111111
04111111111111111111
04111111111111111111
34111111111111111111
22111666666666666666
11111500000000000000
66666500000000000000
00000000000000000000
00000000000000000000
00000000000000000000
00000000000000000000
00000000000000000000
00000000000000000000
00000000000000000000
00000000000000000000
33333333333333333333
22222222222222222222
11111111111111111111
11111111111111111111
11111111111111111111
11111111111111111111
11111111111111111111
66666666666650000000