00000000000000000000
00000000083333370000
00000008341111150000
00000834221111150000
00000422111111150000
00833411111111150000
33422211111111150000
22211111111111150000
11111111111111150000
11111111111111150000
11111111111111150000
11111111111111150000
11111111111111150000
11111111111111150000
11111111111111150000
11111111111111150000
11111111111111150000
11111111111111150000
11111111111111150000
11111111111111150000
11111111111111150000
11111111111111150000
11111111111111153337
11111111111111122225
11111111111111111112
11111111111111111111
11111111111111111111
11111111111111111111
11111111111111111111
66666666666666666666
00000000000000000000
00000000000000000000
00000000000000000000
00000000000000000000
00000000000000000000
00000000000000000000
00000000000000000000
00000000000000000000
00000000000000000000
00000000000000000000
33333333333333333333
22222222222222222222
11111111111111111111
11111111111111111111
11111111111111111111
11111111111111111111
11111111111111111111
46666666666666666666