00000000000000000000
00000000000000000000
00000000000000000000
00000000000000000000
00000000000000000000
00000000000000000000
00000000000000000000
00000000000000000000
00000000000000083700
00000000000000042500
00000000000000046500
00000000000000000000
00000000000000000000
00000000000000000000
00000000000000000000
00837000000000000000
00425000000000000000
00465000000000000083
00000000000000000042
00000000000000000046
00000000000000000000
00000000000000000000
00000000000000000000
33700000000000000000
22533700000000000000
11222533700000000000
11111222500000000000
11111111500000000000
11111111500000000000
66666666500000000000
00000000000000000000
00000000000000000000
00000000000000000000
00000000000000000000
00000000000000000000
00000000000000000000
00000000000000000000
00000000000000000000
00000000000000000000
00000000000000000000
33337000000000000083
22225000000000000042
11115000000000000041
11115000000000000041
11115000000000000041
11115000000000000041
11115000000000000041
66665000000000000046