00000000000000000000
00000000000000000000
00000000000000000000
00000000000000000000
00000000000000000000
00000000000000000000
00000000000000000000
00000000083333700000
00000000042222500000
00000000046666500000
00000000000000000000
00000000000000000000
00000000000000000000
00000000000000000000
00000000000000000000
00000000000000000000
00000000000000000000
70000000000000000000
50000000000000000000
50000000000000000000
00000000000000000000
00000000000000000000
00000000000000000000
00000000008370000000
00000000004250000000
00000000004650000000
00000000000000000000
00000000000000000000
00000000000000000000
00000000000000000000
00000000000000000000
00000000000000000000
00000000000000000000
00000000000000000000
00000000000000000000
00000000000000000000
00000000000000000000
00000000000000000000
00000000000000000000
00000000000000000000
33333333333333333333
22222222222222222222
11111111111111111111
11111111111111111111
11111111111111111111
11111111111111111111
11111111111111111111
66666666666666666666